9 9
4 1 9 9 9 9 9 9 9
0 1 9 8 0 0 0 8 9
0 1 9 0 0 0 0 0 9
0 1 9 0 0 0 0 0 9
0 1 9 0 0 0 0 0 9
0 1 9 0 0 0 0 0 9
0 1 9 0 0 0 3 0 9
0 1 9 8 0 0 0 8 9
0 1 9 9 9 9 9 9 9