11 11
8 0 0 0 0 1 0 0 0 0 8 
0 4 0 0 0 2 0 0 0 4 0 
0 0 9 1 0 1 0 1 9 0 0 
0 0 1 1 2 1 2 1 1 0 0 
0 0 0 2 0 0 0 2 0 0 0 
1 2 1 1 0 8 0 1 1 2 1 
0 0 0 2 0 0 0 1 0 0 0 
0 0 1 1 2 1 2 1 1 0 0 
0 0 9 1 0 1 0 1 9 0 0 
0 4 0 0 0 2 0 0 0 3 0 
8 0 0 0 0 1 0 0 0 0 8
